111111111111111111111
1P000C000000000000001
111011101111011110001
100000001000010000C01
101111101011110111101
10C000001000000000001
111011111011111011101
100010000000000010001
101110111101111011101
100000000C00000000001
1111111111111111111E1